0000000000
0000000000
0000000000
2222222222
3333333333
3333333333
3333333333
3333333333
0000000000
0000000000
