0000000000
0000000000
0000000000
3333333333
0000000000
0011001100
1300000031
3212112123
3223333223
3112002113
