0000110000
0001331000
3333113333
2222222222
0333333330
1113333111
0333333330
0222222220
0000000000
0333333330
